222000000222000
222000000000000
000000000000000
000000222000000
000000222000000
000000222000000
000000000000000
000000000000000
000000000000000
000000000000000
000000000000000