111111111111111111111111111111111111111111111111
111111111111111111111111111111111111111111111111
111111111111111111111111111111111111111111111111
110000000000000000000000000000000000000000000011
110000000000000000000000000000000000000000000011
110011111111111111111111111111111111111111110011
110010010000000000000000000100000000000000010011
110010010000000000000000000100000000000000010011
110010010000000000000000000100001100111110010011
110010000000000000000000000000001100100000010011
110010000000000000000000000000001100100000010011
110010000000000000000000000000001100111111110011
110010010000000000000000000100111100000000010011
110010010000000000000000000100001100000000010011
110010010000000000000000000100001100111110010011
110011111111111111111111111111111100100000010011
110010000000000000000000000000000000100000010011
110010000000000000000000000000000000111111110011
110010011111111111111111111110000000100000010011
110010000000000000000000000010000000100000010011
110010000000000000000000000011111111100010010011
110010011111111111111111110010000000100010010011
110010000000000000000000010000000000000010000011
110010000000000000000000010000100100000011000011
110011111111111111111111111111111111111111110011
110000000000000000000000000000000000000000000011
110000000000000000000000000000000000000000000011
111111111111111111111111111111111111111111111111
111111111111111111111111111111111111111111111111
111111111111111111111111111111111111111111111111